       ?
       
                                                                                                                                OO                             ??                                          %
                                                                                                                       #?#?#            V              OOO                                                <^
      ###                                                                            ##                                                      V     EEEE                                                    p
                                                                           OOOOO                                     OOOOO                                    EEEE                                 EE      P
                                                                          EEEEEEE          V                    #    EEEEE                                                                        EEE      P
OOO                                                            OOOOOOOO                           V                                                      EE                                      EEEE      P
EEE                                                         ###########                                 EEEE                                                                                    EEEEE      P
                                                                                                                                                                                               EEEEEE      P
      v                                             tt                                                                                            ####                                        EEEEEEE      P
                                                    TT                                                                                                                                       EEEEEEEE      P
                 M   OOOOOO      K   OOOO           TT                  K    OOOOOO       M                       E          EE             EE               OOOOOOOOOOOO          M        EEEEEEEEE      E
G         G       G       G       G       G       G       G       G       G       G       G       G       G       G             G              G       G       G       G       G       G       G       G       G