

                                                                                                                                                                                                           %
                                                                                                                                                                                                          <^
                                                                                                                                                                                                           p
                                                                                                                                                                                                   EE      P
                                                                                                                               OOO                                                                EEE      P
                                                           OOO                                                                EEEEEE                                                             EEEE      P
                                                         OO    OO                                                                                                                               EEEEE      P
    #?#                                                 tt       O                        #?###                                                 tt                                             EEEEEE      P
                                                        TT       O                                                   #######            #####   TT                                            EEEEEEE      P
                                                  EE    TT        O                                                                             TT                                           EEEEEEEE      P
          OOOOO  M              OOOOOOOOOO    M         TT         o         K   000000        K         000000                                 TT    M        #   M        OOOO    K       EEEEEEEEE      E
G         G       G       G       G       G       G               G       G       G       G       G       G       G                             G       G       G       G       G       G       G       G       G