                                                                                                                                                                                                              
                                                                                                                                                                                                              
                                                                                                                                                                                                              
                                                                                                                                                                                                   %          
                                                             OO                                                                                                                                   <^          
                                                           EEEE                                                                                                                                    p          
                                                     OOOO                                                                                                                                     EE   P          
                                                    EEEEE                                                                  V                                                                       P          
                                                                                                           OOO                                                         OOO                EEE      P          
                                                      U                                            O    G                                                             O   O          OO            P          
 ##U##                             t          EEE                  O                              O###                                                               O    O          ##            P          
              OOO               EE T                              EEE                            O##                                                                 t     O         #             P          
          G                        T    K           OO                                          O##                  G        M   OOOO                               T     O        ##             P          
                     EEE    OOO    T OO     E      EEEEEE     O        E    M OOOO   M    E    O##                             G               OOOOO M       K       T    G              ####      E          
G                        G         G                        EEEE       G         G           ####                                        G         G         G                                   G  G         