

                                                                                                                                OO                             ??                                          %
                                                                                                                       #?#?#    tt      V              OOO                                                <^
                                                                                              ##                                TT           V        EEEE                                                 p
                                                                                  OOOOO                              OOOOO      TT                            EEEE                                 EE      P
                                                                                 EEEEEEE                        #    EEEEE      TT                                                                EEE      P
                                                               OOOOOOOO   #                V      V     EEEE                    tt                                                               EEEE      P
                                                            ###########                                                                                                                         EEEEE      P
                       K                                                                                                                                                                       EEEEEE      P
                     ####?##                        tt                                                                                                                                        EEEEEEE      P
                                                    TT                                                                          tt                                                           EEEEEEEE      P
                     OOOOOO          OOOO           TT       EEE        K    OOOOOO       M        K                      EE    TT          K             OOOOOOOOOOOO             M        EEEEEEEEE      E
G         G       G       G       G       G       G               G       G       G       G       G       G       G             G       G       G       G       G       G       G       G       G       G       G