

                                                                                                                                                                                                           %
                                                                                                                       #?#?#                                                                              <^
                                                                                                                                                                                                           p
                                                                                                                                                                                                   EE      P
                                                                                                                      EEEEEEE                                                                     EEE      P
                                                               OOOOOOOO                  V                                                                                                       EEEE      P
                                                              #########      V                                       V                                                                          EEEEE      P
                       M    M                                                                              OO                           V                     V               V                EEEEEE      P
                     ####?######?##                 tt                                                    #####?###                                                                           EEEEEEE      P
                                                    TT                                                                                                                                       EEEEEEEE      P
                     OOOO             OOOO          TT        EEE          K  OOOOOO                K                                       K             OOOOOOOOOOOO             M                       E
G         G       G       G       G       G       G               G       G       G       G       G       G       G       G       G       G       G       G       G       G       G       G       G       G       G