       
       
                                                                                                                                                                                                           %
                                                                                                           OOO                                                                                            <^
                                                                                                        tt    OO                                                                                           p
                                                                                               #    ### TT      O      V                                                                           EE      P
                                                          OOOO                                 #        TT       O                                                                                EEE      P
                            #?                          ########                               #        TT       O                                                                               EEEE      P
                                                                                               #        TT        O                                                                             EEEEE      P
                                                                     #####                     ####     TT        O                                                                            EEEEEE      P
                                                                                                        TT        O                           OO                                              EEEEEEE      P
                           EEEE                                                                         TT        O       G                   EEEG                                           EEEEEEEE      P
         K           EEE          #  M  OOO   #         K    ####                M     OOOOO   K        TT        0                   ###                     M  OOOOOOO     M              EEEEEEEEE      E
G         G                       G       G       G               G       G       G       G       G       G       G       G                      G      G       G       G       G       G       G       G       G